阿多	阿多	None
艾德·史塔克	艾德	None
艾德穆·徒利	艾德穆	None
艾莉亚·史塔克	艾莉亚	None
奥伦娜·提利尔	奥伦娜	None
巴利斯坦·赛尔弥	巴利斯坦	None
班扬·史塔克	班扬	班扬叔叔
波德瑞克·派恩	波德瑞克	None
布兰·史塔克	布兰	None
布林登·徒利	布林登	None
大琼恩·安柏	大琼恩	None
戴佛斯·席渥斯	戴佛斯	None
丹妮莉丝·坦格利安	丹妮莉丝	丹妮
多莉亚	多莉亚	None
格雷果·克里冈	格雷果	魔山
贾昆·赫加尔	贾昆	None
杰奥·莫尔蒙	杰奥	None
杰诺斯·史林特	杰诺斯	None
玖健·黎德	玖健	None
凯冯·兰尼斯特	凯冯	None
凯特琳·徒利·史塔克	凯特琳	None
拉姆斯·波顿	拉姆斯	None
莱莎·艾林	莱莎	None
蓝礼·拜拉席恩	蓝礼	None
蓝塞尔·兰尼斯特	蓝塞尔	None
劳勃·艾林	劳勃	None
劳勃·拜拉席恩	劳勃	None
卢斯·波顿	卢斯	None
鲁温学士	鲁温学士	None
罗柏·史塔克	罗柏	None
罗德里克爵士	罗德里克爵士	None
洛拉斯·提利尔	洛拉斯	百花骑士
马林·特兰	马林	None
玛格丽·提利尔	玛格丽	None
梅拉·黎德	梅拉	None
梅丽珊卓	梅丽珊卓	红袍女巫
弥赛拉·拜拉席恩	弥赛拉	None
茉丹修女	茉丹修女	None
欧莎	欧莎	None
派席尔大学士	派席尔大学士	None
培提尔·贝里席	培提尔	小指头
乔佛里·拜拉席恩	乔佛里	None
乔拉·莫尔蒙	乔拉	None
琼恩·雪诺	琼恩	None
瑞肯·史塔克	瑞肯	None
桑铎·克里冈	桑铎	猎狗
瑟曦·兰尼斯特	瑟曦	None
山姆威尔·塔利	山姆威尔	None
珊莎·史塔克	珊莎	None
史坦尼斯·拜拉席恩	史坦尼斯	None
泰温·兰尼斯特	泰温	None
提利昂·兰尼斯特	提利昂	小恶魔
托曼·拜拉席恩	托曼	None
瓦德·佛雷	瓦德	None
瓦里斯	瓦里斯	None
韦赛里斯·坦格利安	韦赛里斯	None
希林·拜拉席恩	希林	None
席恩·葛雷乔伊	席恩	None
雪伊	雪伊	None
耶哥蕊特	耶哥蕊特	None
伊利里欧·摩帕提斯	伊利里欧	None
伊蒙学士	伊蒙学士	None
詹德利	詹德利	None
詹姆·兰尼斯特	詹姆	弑君者
卓戈·卡奥	卓戈	None